{
    "level": 1,
    "width": 10,
    "height": 15,
    "layout": [
        1, 1, 1, 1, 1, 1, 1, 1, 1, 1,
        1, 2, 2, 0, 0, 0, 0, 0, 0, 1,
        1, 6, 11, 0, 0, 0, 0, 0, 10, 1,
        1, 0, 10, 0, 0, 8, 0, 0, 0, 1,
        1, 0, 3, 0, 0, 0, 0, 0, 0, 1,
        1, 1, 1, 1, 1, 1, 0, 0, 0, 1,
        1, 4, 0, 0, 0, 0, 0, 0, 0, 1,
        1, 0, 0, 0, 0, 9, 0, 0, 0, 1,
        1, 4, 0, 0, 0, 0, 0, 9, 0, 1,
        1, 1, 1, 1, 1, 1, 0, 10, 0, 1,
        1, 0, 0, 0, 0, 0, 0, 0, 0, 1,
        1, 0, 0, 0, 0, 0, 0, 0, 0, 1,
        1, 2, 2, 0, 0, 0, 0, 0, 0, 1,
        1, 3, 3, 0, 0, 0, 0, 0, 12, 1,
        1, 1, 1, 1, 1, 1, 1, 1, 1, 1
    ]
}