{
    "level": 1,
    "width": 21,
    "height": 21,
    "layout": [
        0, 26, 27, 27, 27, 27, 27, 27, 28, 0, 200, 0, 29, 27, 27, 27, 27, 27, 27, 30, 0,
        26, 28, 1, 1, 1, 1, 1, 1, 1, 1, 1, 1, 1, 1, 1, 1, 1, 1, 1, 29, 30,
        40, 1, 1, 1, 1, 1, 1, 1, 1, 1, 1, 1, 1, 1, 1, 1, 1, 1, 1, 1, 41,
        40, 1, 1, 1, 1, 1, 1, 1, 1, 1, 1, 1, 1, 1, 1, 1, 1, 1, 1, 1, 41,
        40, 1, 1, 1, 1, 1, 1, 1, 1, 1, 1, 1, 1, 1, 1, 1, 1, 1, 1, 1, 41,
        40, 1, 1, 1, 1, 1, 1, 1, 1, 1, 1, 1, 1, 1, 1, 1, 1, 1, 1, 1, 41,
        40, 1, 1, 31, 32, 32, 32, 33, 1, 1, 1, 1, 1, 1, 1, 1, 1, 1, 1, 1, 41,
        40, 1, 1, 42, 34, 34, 34, 44, 1, 1, 1, 1, 31, 32, 32, 33, 1, 1, 1, 1, 41,
        28, 1, 1, 42, 34, 34, 34, 44, 1, 1, 1, 1, 42, 43, 43, 44, 1, 1, 1, 1, 29,
        0, 1, 1, 42, 43, 34, 43, 44, 1, 1, 1, 1, 56, 57, 58, 59, 1, 1, 1, 1, 0,
        201, 1, 1, 56, 35, 43, 38, 59, 1, 1, 1, 1, 68, 69, 70, 71, 1, 1, 1, 1, 201,
        0, 1, 1, 68, 46, 57, 49, 71, 1, 1, 1, 1, 1, 1, 1, 1, 1, 1, 1, 1, 0,
        53, 1, 1, 1, 1, 1, 1, 1, 1, 1, 1, 1, 1, 1, 1, 1, 1, 1, 1, 1, 54,
        40, 1, 1, 1, 1, 1, 1, 1, 1, 1, 1, 1, 1, 1, 1, 1, 1, 1, 1, 1, 41,
        40, 1, 1, 1, 1, 1, 1, 1, 1, 1, 1, 1, 1, 1, 1, 1, 1, 1, 1, 1, 41,
        40, 1, 1, 1, 1, 1, 1, 1, 1, 1, 1, 1, 1, 1, 63, 64, 65, 66, 67, 1, 41,
        40, 1, 1, 1, 1, 1, 1, 1, 1, 1, 1, 1, 1, 1, 1, 1, 1, 1, 1, 1, 41,
        40, 1, 1, 1, 1, 1, 1, 1, 1, 1, 1, 1, 1, 1, 1, 1, 1, 1, 1, 1, 41,
        40, 1, 1, 1, 1, 1, 1, 1, 1, 1, 1, 1, 1, 1, 1, 1, 1, 1, 1, 1, 41,
        51, 53, 1, 1, 1, 1, 1, 1, 1, 1, 1, 1, 1, 1, 1, 1, 1, 1, 1, 54, 55,
        0, 51, 52, 52, 52, 52, 52, 52, 53, 0, 200, 0, 54, 52, 52, 52, 52, 52, 52, 55, 0
    ],
    "decorations": [],
    "enemies": []
}