{
    "level": 1,
    "width": 21,
    "height": 21,
    "layout": [
        0, 26, 27, 27, 27, 27, 27, 27, 28, 0, 200, 0, 29, 27, 27, 27, 27, 27, 27, 30, 0,
        26, 28, 1, 1, 1, 1, 1, 1, 1, 1, 1, 1, 1, 1, 1, 1, 1, 1, 1, 29, 30,
        40, 1, 1, 1, 1, 1, 1, 1, 1, 1, 1, 1, 1, 1, 1, 1, 1, 1, 1, 1, 41,
        40, 1, 1, 1, 1, 1, 1, 1, 1, 1, 1, 1, 1, 1, 1, 1, 1, 1, 1, 1, 41,
        40, 1, 1, 1, 1, 1, 1, 1, 1, 1, 1, 1, 1, 1, 1, 1, 1, 1, 1, 1, 41,
        40, 1, 1, 1, 1, 1, 1, 1, 1, 1, 1, 1, 1, 1, 1, 1, 1, 1, 1, 1, 41,
        40, 1, 1, 1, 1, 1, 54, 52, 53, 1, 1, 1, 54, 52, 53, 1, 1, 1, 1, 1, 41,
        40, 1, 1, 1, 1, 1, 41, 0, 40, 1, 1, 1, 41, 0, 40, 1, 1, 1, 1, 1, 41,
        28, 1, 1, 1, 1, 1, 29, 27, 28, 1, 1, 1, 29, 27, 28, 1, 1, 1, 1, 1, 29,
        0, 1, 1, 1, 1, 1, 1, 1, 1, 1, 1, 1, 1, 1, 1, 1, 1, 1, 1, 1, 0,
        201, 1, 1, 1, 1, 1, 1, 1, 1, 1, 300, 1, 1, 1, 1, 1, 1, 1, 1, 1, 201,
        0, 1, 1, 1, 1, 1, 1, 1, 1, 1, 1, 1, 1, 1, 1, 1, 1, 1, 1, 1, 0,
        53, 1, 1, 1, 1, 1, 54, 52, 53, 1, 1, 1, 54, 52, 53, 1, 1, 1, 1, 1, 54,
        40, 1, 1, 1, 1, 1, 41, 0, 40, 1, 1, 1, 41, 0, 40, 1, 1, 1, 1, 1, 41,
        40, 1, 1, 1, 1, 1, 29, 27, 28, 1, 1, 1, 29, 27, 28, 1, 1, 1, 1, 1, 41,
        40, 1, 1, 1, 1, 1, 1, 1, 1, 1, 1, 1, 1, 1, 1, 1, 1, 1, 1, 1, 41,
        40, 1, 1, 1, 1, 1, 1, 1, 1, 1, 1, 1, 1, 1, 1, 1, 1, 1, 1, 1, 41,
        40, 1, 1, 1, 1, 1, 1, 1, 1, 1, 1, 1, 1, 1, 1, 1, 1, 1, 1, 1, 41,
        40, 1, 1, 1, 1, 1, 1, 1, 1, 1, 1, 1, 1, 1, 1, 1, 1, 1, 1, 1, 41,
        51, 53, 1, 1, 1, 1, 1, 1, 1, 1, 1, 1, 1, 1, 1, 1, 1, 1, 1, 54, 55,
        0, 51, 52, 52, 52, 52, 52, 52, 53, 0, 200, 0, 54, 52, 52, 52, 52, 52, 52, 55, 0
    ],
    "decorations": [],
    "enemies": []
}